..................................................................!
##################################################################!
#................................................................#!
#................................................................#!
#................................................................#!
#................................................................#!
#................................................................#!
#................................................................#!
#..............########............#######.......................#!
#.....................#............#.............................#!
#.....................#............#.............................#!
#.....................#............#.............................#!
#.....................#............#.............................#!
#.....................#............#.............................#!
#..............########............#######.......................#!
#................................................................#!
#................................................................#!
#................................................................#!
#................................................................#!
#................................................................#!
#................................................................#!
##################################################################!
